41,13
11111111111111111111111111111111111111111
10000000000000000000000000000000000000001
10000000000000000011111111111111110000001
10000000111111111111111111111111111100001
10000000000000010000000000000000000000001
10000000000000010000000000000001111111111
10000000000111110000000000000000000000001
10000000000000010000000000000000000000001
10000000001111110100000000000000000100001
10000000000000000000000000000000000000001
10000000000000000000000000000000000000001
10000000000000000000000000000000000000001
11111111111111111111111111111111111111111
#warps[x,y,id,dx,dy]
1,3,0,1,1
